XXXXXXXXXXXXXXXXXXXXXXXXXXXXXXXXXXXXXXXXXXXXXXXXXXXXXXXXXXXXXXXXXXXXXXXXXXXXXXXX
X..................................^  ^   ^  ^  ^   ^  ^.......................X
X................................./|\/|\ /|\/|\/|\ /|\/|\......................X
X................................./|\/|\ /|\/|\/|\ /|\/|\......................X
X..............................................................................X
X.................................................................^............X
X................................................................/|\...........X
X.......^  ^  ^................................................../|\...........X
X....../|\/|\/|\................................................./|\...........X
X....../|\/|\/|\...............................................................X
X....../|\/|\/|\...............................................................X
X..............................................................................X
X..............................................................................X
X.............................................^  ^  ^   ^......................X
X............................................/|\/|\/|\ /|\.....................X
X............................................/|\/|\/|\ /|\ ....................X
X............................................/|\/|\/|\ /|\.....................X
X..............................................................................X
X..............................................................................X
XXXXXXXXXXXXXXXXXXXXXXXXXXXXXXXXXXXXXXXXXXXXXXXXXXXXXXXXXXXXXXXXXXXXXXXXXXXXXXXX